I assets/platform-tiles.png
R 4
C 4


T B,6
T G,7
T L,0
T C,1
T R,2
T l,4
T r,5

N 0


L G,G,G,G,G,G,G,G,G,G,G,G,G,G,G,G,G,G,G,G,G,G,G,G,G
L G,0, , , , , , , , , , , , , , , , , , , , , , ,G
L G, , , , , , , , , , , , , , , , , , , , , , , ,G
L G, , , , , , , , , , , , , , , , , , , , , , , ,G
L G, , , , , , , , , , , , , , , , , , , , , , , ,G
L G, , , , , , , , , , , , , , , , , , , , , , , ,G
L G, , , , , , , , , , , , , , , , , , , , , , , ,G
L G, , , , , , , , , , , , , , , , , , , , , , , ,G
L G, , , , , , , , , , , , , , , , , , , , , , , ,G
L G, , , , , , , , , , , , , , , , , , , , , , , ,G
L G, , , , , , , , , , , , , , , , , , , , , , , ,G
L G, , , , , , , , , , , , , , , , , , , , , , , ,G
L G, , , , , , , , , , , , , , , , , , , , , , , ,G
L G, , , , , , , , , , , , , , ,G,G,G, , , , , , ,G
L G, , , , , , , , , , , , ,G,G,G,G,G, , , , , , ,G
L G, , , , , , , , , , ,G,G,G,G,G,G,G, , , , , , ,G
L G, , , , , , , , ,G,G,G,G,G,G,G,G,G, , , , , , ,G
L G, , , , , , ,G,G,G,G,G,G,G,G,G,G,G, , , , , , ,G
L G,2, , , ,G,G,G,G,G,G,G,G,G,G,G,G,G, , , , , , ,G
L C,C,C,C,C,C,C,C,C,C,C,C,C,C,C,C,C,C,F,F,F,F,F,F,C